
                               v
                         #######
                    #####
 @             #####
#######    ####
     #######

                                     0
                              #########